NO test_maps/textures/north_wall.xpm
SO test_maps/textures/south_wall.xpm
WE test_maps/textures/west_wall.xpm
EA test_maps/textures/east_wall.xpm
DOOR test_maps/textures/door.xpm

F 184,113,39
C 51,198,227

11111111111111111111111111111111111111111111
10000000000000000000000000000000000000000001
10000000000000000000000000000000000000000001
10000000000000000000000000000000000000000001
10000000000000000000000000000000000000000001
10000000000000000000000000000000000000000001
10000000000000000000000000000000000000000001
10000000000000000000000000000000000000000001
10000000000000000000000000000000000000000001
10000000000000000000000000000000000000000001
10000000000000000000000000000000000000000001
10000000000000000000010000000000000000000001
100000000000000000000O00000001C1000000000001
10000000000000000000010000000000000000000001
100000000000000000000C0000000000000000000001
10000000000000000000010000000000000000000001
10000000000000000000000000000000000000000001
10000000000000000000000000000000000000000001
10000000000000000000000000000000000000000001
10000000000000000000000000000000000000000001
10000000000000000000000000000000000000000001
10000000000000000000000000000000000000000001
10000000000000000000000000E00000000000000001
11111111111111111111111111111111111111111111