NO test_maps/textures/north_wall.xpm
SO test_maps/textures/south_wall.xpm
EA test_maps/textures/east_wall.xpm
WE test_maps/textures/west_all.xpm
DO test_maps/textures/door.xpm

F 100,100,100
C 200,200,255

111111111111111111111111111111111
10000001000000010000000100000001
101110101011101010111010101111101
101000101000101010001010100000101
101011111010101011101010111110101
1010000000101010001010100000101010
111110111110101110101011111010101
100000100000101000101000001010101
101111101111101011101111101010101
101000001000001010001000101010101
101011101011111010101110101010101
101010001010000010101100101010101
101010111010111110101011101011100
101010000010100000101110001010001
101011111110101111101010111010111
101000000000101000101010000010101
111111111110101110101011111110101
100000000000101000101000000000101
10111111111110111110111111111111111
10100000000000N0000000000000000001
10111111111111011111111111111110111
10100000000000000000000000000001
111111111111111111111111111111111

    