NO test_maps/textures/north_wall.xpm
SO test_maps/textures/south_wall.xpm
WE test_maps/textures/west_wall.xpm
EA test_maps/textures/east_wall.xpm

F 220,100,0
C 225,30,0

1111111111111111111111111
1000000000110000000000001
1011000001110000000000001
1001000000000000000000001
1111111110110000011100001
1000000000110000011101111
1111011100000000000000001
1111011110000000111010101
1100000000000000000000001
100000S000000000110000001
1000000000000000110101001
1100000111010101111101111
11110111 1110101 10111101
11111111 1111111 11111111