NO test_maps/textures/north_wall.xpm
SO test_maps/textures/south_wall.xpm
WE test_maps/textures/west_wall.xpm
EA test_maps/textures/east_wall.xpm
DO test_maps/textures/door.xpm

F 220,100,0
C 225,30,0

        1111111111111111111111111
        1000000000110000000000001
        1011000001110000000000001
        1001000000000000000000001
111111111011000001110000000000001
100000000011000001110111111111111
11110111111111000000000010001
11110111111111011101010010001
11000000110101011100000000001
10000000000000001100000010001
1000000000000000CC010100C0001
11000001110101011111011110N0111
11110111 1110101 101111010001
11111111 1111111 111111111111